1111111111111111111111111
1                       1
1                       1
1                       1
133333             333331
1                       1
1                       1
1                       1
1        3333333        1
1                       1
1                       1
1                       1
1    333333333333333    1
1                       1
1                       1
1                       1
13333333                1
1                       1
1                       1
1                       1
1          33333333333331
1                       1
1                       1
1                       1
2222222222222222222222222



